qqq: pie
bqg: kso
pku: exf qzf
cno: wvx wzf xhs ond bhf qnp
hnc: yzf
lnu: urp fyx cgs
mqm: fup spc xoa
hhr: jrk ftd
txs: lpt
lew: zpn
yxu: hru qhr vjj tsq
wzf: kni mmq erz
kdx: fup spc
qks: kqc
wdu: urq psb
jiq: abw xgs sbj jax vmt
jnm: erz
dmr: yzf exf qzf
juy: avp ffl
nzd: brq apx kcd yrh
lys: slx tlt
boe: fnf cfe ckj
rkw: eby anz
jta: weg dgp
bqx: dgp
rcy: msn qwu
rhg: myd fkk
gwr: lyy lqi
hpd: irb hjn qgh
cpx: you
zzx: cno afb mfc
dpf: ojt myw nvw
gff: fym bfy lew
nya: cxl nib
sbj: txs
ije: srh ggj
xwk: ejg ocr
rrx: you
vfh: npe hzv
nri: myd fkk vrb
itl: myd
tlt: uod olw mkr
bnd: jek
glj: ztq ifl loa gmv
jmw: ykk zuc tlt gai
phb: zdg xpo tuf
ffl: out
unq: out
mem: pmu lcu yzw
uoy: bya
gzb: nau emj osw vpw
osw: ihc
zpz: ale qif
fup: out
num: chv cus
ldt: nib lmg
fkk: rmc vrj ksy oio kgz jrm uer mpv iup rkw xwk
flu: afb
cus: hzs nra
gkq: myd fkk
tpr: hru qhr vro tsq
xnt: ifl loa
irb: you lpt
yma: txi qed svl
bnf: kdx pgr
lil: jvx zqo kpj run
shu: tpr itc hzp sou
dsf: xfi yao hkk
att: gbc
xex: cpx att
zxt: zwj rky
ejc: bya afb
ccp: yad wfe vqk
gvy: qif ale
qzf: gsr puu cim ntx kye hho tkx kqi oza gzb ikj pdl cdh mho mem jgq vsy kbj bkg zxt
shb: zdn jvv ytl vtr
dcm: beo rdt rxz joo
cfe: lek
rst: vhl nri
avp: out
awh: bfc
qwu: lvm rfn ifx
lcu: bqg che usy luw
urp: tip
ikk: iwb
vvp: pxo pnu
byj: nlo sdv
vsy: blt cvq
cgs: tip
amk: cpz
yju: nvj urq
qed: elt nmc rrx ngv
vrr: bnf kcd
fru: dgp
lvm: exf oxe
rvi: lno fpd bgp
fxa: vud skt
fdl: weg
usy: weg dgp
cpz: you lpt gbc
lek: wdu yju bdo
ujk: mmq erz
vtr: oxe yzf qzf exf
mae: exf oxe
hho: yzw lcu pmu
agh: zyr srh
sqr: tit nth cym
osp: osm
mkr: mfc afb cno bya
bgh: ifl
hqc: dgp kso weg
fsx: ale
rmc: eby
vrb: ksy vrj lfl kgz jrm xop tig ett cel mpv uer tgh xwk raz
lzx: myd fkk vrb
cut: out
pnu: mgz swy ala tys
wvt: ceh juz mlp
rov: iqo kos
ocr: nfw xfi hkk
mor: bfc
jgq: gwr ygh the
otk: ceh bic
elb: hmk
wje: syo ptk
orx: llu enn att ssp
fll: out
svr: nai mkx zix ypa
crk: rst edx
svl: nmc rrx xak
mgv: vrb
iou: cus
hsy: qvf xex fae orx
ihc: weg dgp kso
zpu: ztq ifl
oio: rkm ipx vjw tlm
dlc: sbj vmt xgs
rty: irb hjn gyo
wue: fkk myd
wfe: itl jbs qhu ksq
hsp: ydt qav dpt vls
vfs: qhu jho ksq
hkx: dec ltg oft wsh mmb
myw: vgt gbv wbp dac
gyo: you lpt
bfc: vrb fkk myd
ebb: spm qpe jrk mmp
jni: dxu bqx
uvu: ida lys sgo
iwb: swy mgz
evx: bya
oyg: fkk
csj: xag
jvv: exf qzf yzf
bfy: zpn bqx fdl
iub: vrr nzd
rgp: jvv
bdk: ezq
pmu: snn luw che bqg
shd: qzf
dcv: hjn gyo irb
hhq: hzz flu zzx uoy
nib: xnl zhm jey yin uam
yoq: lmg nib
fgq: szd
elr: fdd kvs
uxe: nth jta
knz: kso weg
iup: lil kvs fjs fdd
xag: spm jrk qpe
sht: uoy zzx
tig: gte wnk rgp shb
dwj: cge zka uho vzt
now: cmv spg uvu
swy: lwb xcc wue
szd: eib
smj: pda
eib: mgz tys ala
uer: lil edr kvs fdd
ybz: oxe qzf yzf
bdo: nvj urq
weg: fqi lmw axs xhb dei yky gde yma sju lfh zrb ogs fcq hnu phv coa
tsq: mfc afb bya cno yag
wle: wxw lvm tcf ifx
tlm: mae pku
vcs: ybm hzv npe
edr: whx jvx zqo kpj run
fft: mor edx
kqc: sht wmr hhq urr
ond: skm ikk pie vvp
rlc: fft iib
zpn: dgp
ght: kqc
dpw: out
mmq: wde lzx mdl
fus: ckj fnf cfe smj
wjc: smj ckj fnf
iib: awh
rxz: gvy vvv zpz
vro: mfc yag bya cno
nej: ahr
llu: hkx gbc you
zhm: uzd crx ejc
che: dgp kso
ygh: fru lqi lyy
bil: exf yzf
jrm: dsf
zjz: fsx gvy
tkx: ptn uxe
slx: jxd olw
nvt: dpe fxa
oxe: ntx mem tkx bkg zxt puu
swi: mmq
xfi: rov
iqs: shd dmr xuz
ndt: qja eho ovs
gsr: blt
tuf: fpd bgp lno
xnl: crx
vjj: afb mfc yag bya
fcq: alq
asv: elb
nai: rhn xoj ldt dwj ppu ags asv mhs shu nya efp eeq zhu pit now bnd bwo ges gka
jix: yvf
eho: bgx ewm
tcf: yzf
eai: iib fft ahr
txi: xak ngv rrx
nlo: fyx urp fls cgs
lgx: rjo
jok: qsr wfa ubt
ypa: mhs dwj pit yoq qec eeq gka ges bwo
qkb: srh zyr
skt: xex
ojt: dac wbp xxd gbv
afb: ccp ujk swi xhs utx ndt fgq xjb wvx qqq bhf jnm jol wzf myf awq ond ygx
jxd: bya yag mfc afb
coa: myw nvw guv ojt
lno: rhg she reg
swx: you lpt hkx
ikj: yzw lcu pmu jry
jol: vfs wfe vqk
elt: you hkx lpt
mfc: wvx xjb ndt utx oxi xhs ujk swi ygx ond axc myf qnp jnm bhf jol qqq
lpt: wvt bpr zpb qyf fus miu boe dec voe mmb ckm jok vcs vfh wsh oft wjc kmb
olw: cno
vjw: pku
ckm: wfa ogj ubt
fae: ssp llu cpx enn
pel: out
zvk: fdl dxu bqx zpn
pda: pvs
ept: lnu
tit: weg kso dgp
mho: osw vpw emj nau
gfz: ptk
uho: jxh bdk
qnq: avp dra
fyx: cut
ptn: cym nth tit
fnp: cpx att enn ssp
exf: pdl dsw jgq mem zxt bkg cim puu hho tkx ikj gzb
eoa: mfc bya yag
iqv: enq syo
vmv: xxd gbv
xgs: txs eke
kqo: brq yrh
nvw: dac xxd gbv vgt
wde: myd fkk
kbj: ptn sqr uxe
eby: msn wle qwu
xoa: out
kqi: dcm cvq
lyy: weg
eeq: uho zka cge
rhn: uho lzw vzt
tys: mgv
ngv: gbc hkx
ydt: vrr
kdn: ejg ocr
zix: ges now zhu qec eeq efp nya shu mhs ags dwj ppu ldt xoj yoq
uzc: svh dlc
mno: ftd spm
pie: pnu
ovs: bgx ewm rzr
cge: aph
bgx: myd
nra: gbc you
dyy: gyo
lmg: zhm jey yin uam
ogs: vst
xpo: lno fpd
lgo: out
jxh: uyl evx
uzd: afb mfc yag bya cno
ppu: yxu sou
hnu: dpe
vzm: dlc
xcc: vrb myd
ytl: exf
wmr: hzz flu
vls: nzd vrr
zpb: ybm hzv bga
dxu: dgp kso
bgp: reg
yzf: cdh mho mem vsy gsr puu vvk ntx ikj oza gzb tkx kqi
jey: ejc crx uzd
mdl: myd vrb
juz: isf byj ept
zwj: bfy lew zvk jni
hpx: xpo zdg tuf rvi
cxl: jey zhm yin
dlf: dlc jiq svh
kps: bil hnc iqo kos
zyr: out
wvx: eai rlc qlt nej fns
qav: kqo
syo: gze juy
ahr: edx rst awh mor ymi
emo: num oac
vhl: vrb
jek: lys jmw
bkg: mbw sqr
lzw: bdk
uod: afb yag bya cno
emj: hqc ihc
vpp: you gbc hkx
zuc: olw mkr
wag: hnc
zqo: exf
zrb: myw nvw
yag: oxi ygx awq jol axc qqq
ymi: vhl bfc
myf: kni
erz: oyg wde zwf lzx
bwo: dwf ght qks fqm
yin: eoa ejc crx uzd
hjn: hkx
njm: bdo pvs wdu
mkx: nya xoj rhn mhs asv dwj ppu ags bnd gka ges eeq efp now pit zhu
luw: kso dgp
vzt: bdk jxh
rzr: fkk
kso: ugq xhb axs yky lmw fqi iis sju yma iny nvt dpf ogs zrb lfh coa ivx fef phv hnu
fua: ebb hhr mno
iqo: qzf
mgz: wdd mgv lwb wue
sou: vro tsq
ges: qks ght
cdh: the oqu
spm: unq wkf
hzz: yag bya
brq: mqm pgr kdx
qlm: zyr srh
ceh: hrj isf
skm: iwb pnu pxo
nmc: you gbc hkx lpt
fqm: hmk kqc bpl
run: yzf oxe
xak: you gbc hkx
alq: hsy
kni: mdl zwf lzx wde oyg
ejg: nfw xfi yao
phv: dpk
rfn: oxe qzf
iir: rzr ewm
qlt: iib crk
ezq: yag cno bya mfc
ikt: hkx gbc you
ksy: vjw tlm
bpr: ctt
sgr: edr kvs lil
yao: rov wag
rky: jni zvk
ygx: wfe vfs vqk yad
dgp: lmw lfh fqi nvt dei xhb emo hnu fef
ckj: njm lek
she: myd fkk vrb
gep: rvi
nau: knz hqc ihc
gmv: qlm ije mgp
xuz: yzf exf qzf
qvf: cpx
xhb: rty dcv dyy
vvk: ygh
jry: usy bqg che snn
jrk: wkf fll
psb: pel khd
ifl: qkb mgp ije agh
sdv: urp fyx cgs
bhf: fns eai rlc
tgh: rkm vjw ipx
nth: dgp weg
mmb: ckj fnf cfe
vqk: itl jbs
ifx: oxe qzf
qpe: wkf unq fll
dpe: vud hsy skt
srh: out
abw: eke cdo txs adh
dwf: kqc bpl
pit: cmv spg uvu
cim: gff
ctt: csj fua yhh wsk
chv: ikt
zdn: oxe qzf yzf
lis: hjn gyo qgh
wsh: ckj
xop: rkm tlm
ksq: fkk myd vrb
utx: gep phb hza
jax: adh eke
urr: rjo hzz flu
cjq: dra avp ffl
aph: uyl
fqi: hpd rty lis dyy dcv
hru: bya
jre: swx cpz vpp
oft: ceh mlp bic juz
anz: qwu msn res
crx: mfc cno yag
wdd: vrb fkk
bpl: hhq urr
raz: iqs yvf ckl
cel: osp rgp shb wnk gte
dra: out
awq: eai rlc
lfh: ojt guv vmv
uam: ejc uzd crx
iis: alq
itc: qhr
bya: ujk lmi oxi ndt fgq
lqi: weg kso dgp
lwb: vrb myd fkk
kvk: cus chv
wkf: out
qsr: zpu
yky: kvk num ojd oac iou
ltg: vls dpt iub qav ydt
apx: pgr kdx
eke: gbc hkx lpt you
rkm: ybz mae
fnf: njm
wxw: qzf
qhu: fkk
whx: exf
mgp: ggj
msn: rfn wxw
hza: zdg rvi
ntx: ygh oqu gwr
kzi: ckl
cvq: rxz joo
adh: gbc hkx you
bhu: rzr
wnk: jvv vtr osm ytl
gbv: jre lqt
cym: kso
prv: fua yhh csj
axs: kvk num oac
oxi: bhu ovs iir qja eho
kgz: vjw
gze: ffl
guq: dlc svh
kye: osw vpw nau
the: fru lqi
lqt: cpz vpp
loa: agh mgp
pvs: nvj urq psb
reg: vrb myd
zdg: fpd bgp lno
rjo: mfc
puu: uxe sqr
iny: dyy
wfa: zpu glj xnt bgh
eut: yhh wsk
rdt: zpz
urq: khd pel xxi
fdd: zqo
blt: rxz beo rdt zjz joo
sju: ojd num iou oac
gbc: bpr qyf zpb miu fus dec mmb voe jok ckm vfh vcs hsp wjc oft otk ltg kmb
npe: gfz
bxf: nra hzs
ssp: lpt hkx you
ett: yvf iqs
nfw: kps
xhs: vvp ikk pie szd
xxi: out
hmk: lgx urr wmr hhq sht
sgo: slx gai
hzp: vjj
ykk: mkr
yad: jho
ztq: qkb mgp agh
dac: jre amk lqt
pxo: mgz aee tys swy
spg: jmw sgo
ugq: guq
aee: wue wdd lwb
bng: swx vpp
ida: gai ykk zuc slx
qyf: ydt qav vls iub dpt
efp: nib
dpt: nzd vrr
qhr: cno bya yag afb mfc
dec: npe ybm
mmp: wkf fll ndp
bga: mtg wje iqv
enn: hkx you
myd: uer rkw elr jix tgh iup lfl vrj ksy kdn jrm kgz ett cel kzi fwy xwk rmc sgr xop oio tig
enq: qnq
bic: byj ept hrj
nvj: pel xxi
axc: hpx gep hza
hkk: rov kps
lna: weg
fym: fdl bqx
zka: aph jxh
dei: txi vst
gde: guq vzm dlf uzc
qnp: qlt
ale: dgp weg
vrj: rgp wnk
miu: prv
fpd: she
qif: dgp kso
ojd: bxf
vud: fnp qvf fae
res: rfn lvm
ala: wdd
uyl: mfc afb bya cno
vvv: lna
hrj: nlo sdv
hzs: lpt hkx gbc you
ptk: qnq cjq juy
edx: vhl nri
yzw: che snn luw
ipx: ybz mae
voe: qsr wfa ogj
gka: jek cmv uvu spg
lmw: dcv lis
osm: exf qzf oxe
gai: mkr olw uod
ftd: wkf ndp fll
khd: out
oza: the ygh gwr oqu
ags: qks dwf fqm elb
joo: zpz fsx gvy
hzv: mtg iqv
kvs: whx
yhh: ebb mno
vmt: eke adh cdo
mtg: ptk
kcd: mqm pgr
isf: nlo lnu
you: kmb boe vcs miu bpr zpb qyf voe jok
ogj: bgh
ggj: out
beo: gvy zpz vvv
pgr: lgo spc
mpv: yvf
qgh: gbc hkx lpt you
fwy: anz rcy
guv: xxd wbp
pdl: gff zwj
ckl: shd
cmv: ida
vgt: lqt bng
spc: out
yrh: mqm
xoj: dwf
kmb: ctt prv eut
fef: vzm dlf
ivx: ojt guv vmv nvw
vst: xak ngv rrx nmc
ybm: gfz iqv
yvf: shd xuz xys
xjb: bhu
zhu: lzw uho zka cge
fjs: kpj
kos: exf oxe
fns: crk
mlp: isf ept
xxd: amk jre
ubt: bgh zpu glj
qec: zka cge vzt lzw
jvx: oxe
kpj: oxe yzf qzf
mbw: nth tit
lmi: hpx gep phb hza
lfl: anz eby
jho: vrb
dsw: zwj
ewm: vrb fkk myd
gte: ytl vtr
wbp: amk jre
zwf: fkk myd
svh: jax sbj vmt abw xgs
cdo: you gbc hkx
snn: kso weg
wsk: ebb mno
fls: dpw cut tip
jbs: myd fkk
dpk: elt nmc rrx ngv
qja: gkq
tip: out
xys: oxe exf yzf
oqu: lqi
ndp: out
oac: cus chv
mhs: tpr yxu
vpw: hqc
